13
13
3 3 3 3 3 3 3 3 3 3 3 3 3
3 0 0 0 0 1 1 1 0 0 0 0 3
0 0 0 0 0 1 1 1 0 0 0 0 0
1 1 1 1 1 1 1 1 1 1 1 1 1
2 4 4 4 4 1 1 1 4 4 4 4 2
1 1 9 2 2 1 1 1 2 2 0 1 1
1 1 1 2 2 1 1 1 2 2 0 1 1
1 4 4 4 4 1 1 1 4 4 4 4 0
3 0 2 0 0 1 1 1 0 0 2 0 3
0 0 1 1 0 1 1 1 1 1 1 2 0
0 0 1 0 0 1 1 1 0 0 0 0 0
3 0 1 0 0 1 1 1 0 0 0 0 3
3 3 3 3 3 3 3 3 3 3 3 3 3 
5 5