13
13
0 0 0 0 3 3 3 3 0 0 0 0 0
0 0 0 0 0 0 0 0 0 0 0 0 0
0 3 4 4 4 4 4 4 4 4 4 3 0
0 3 3 1 1 1 1 1 1 1 3 3 0
0 1 1 1 0 0 0 0 0 1 1 1 0
0 1 1 1 4 2 2 2 4 1 1 1 0
0 1 1 1 4 2 9 2 4 1 1 1 0
0 1 1 1 4 2 2 2 4 1 1 1 0
0 1 1 1 0 0 0 0 0 1 1 1 0
0 3 3 1 1 1 1 1 1 1 3 3 0
0 3 4 4 4 4 4 4 4 4 4 3 0
0 0 0 0 0 0 0 0 0 0 0 0 0
0 0 0 0 3 3 3 3 0 0 0 0 0
5 5