13
13
2 2 2 2 2 2 2 2 2 2 2 2 2
2 0 0 0 0 0 0 0 0 0 0 0 2
2 0 1 1 1 1 1 1 1 1 1 0 2
2 0 1 1 4 4 1 4 4 1 1 0 2
2 0 1 3 1 4 1 4 1 3 1 0 2
2 0 1 3 3 0 0 0 3 3 1 0 2
2 0 1 3 3 3 0 3 3 3 1 0 2
2 0 1 3 3 0 0 0 3 3 1 0 2
2 0 1 3 1 4 1 4 1 3 1 0 2
2 0 1 1 4 4 1 4 4 1 1 0 2
2 0 1 1 1 2 1 2 1 1 1 0 2
2 0 0 0 0 2 9 2 0 0 0 0 2
2 2 2 2 2 2 2 2 2 2 2 2 2 
5 5 
1 1
2 13